11111111111111111
10000000000000001
10000111110000001
10001110000000C01
11110000000000001
1000P011111101001
10000000100001001
11111111100010001
10000E00100000001
11111111111111111