111111
1CE001
111001
100001
100P01
111111
