1111111111111111111
1000000000C00000011
100P00000C111111001
1111000001C00010011
111111000000011E111
1111111111111111111